WIDTH=21
HEIGHT=21
1,1,1,1,1,1,1,1,1,1,1,1,1,1,1,1,1,1,1,1,1
1,0,0,0,0,2,5,1,7,0,2,0,7,1,0,2,0,0,0,0,1
1,0,3,0,0,1,5,2,0,1,4,1,0,2,5,1,0,0,4,0,1
1,0,0,0,0,2,1,2,0,2,0,2,0,2,1,2,0,0,0,0,1
1,2,1,2,1,5,0,0,1,0,2,0,1,0,0,5,1,2,1,2,1
1,0,1,0,6,1,2,0,0,2,0,2,0,0,2,1,6,0,1,0,1
1,5,1,1,0,0,0,1,7,0,1,0,7,1,0,0,0,1,1,5,1
1,0,2,0,2,1,7,2,0,2,5,2,0,2,7,1,2,0,2,0,1
1,2,0,2,5,0,2,0,2,1,0,1,2,0,2,0,5,2,0,2,1
1,1,0,0,1,0,0,2,0,0,6,0,0,2,0,0,1,0,0,1,1
1,1,1,0,4,2,1,0,2,2,1,2,2,0,1,2,4,0,1,1,1
1,1,0,0,1,0,0,2,0,0,6,0,0,2,0,0,1,0,0,1,1
1,2,0,2,5,0,2,0,2,1,0,1,2,0,2,0,5,2,0,2,1
1,0,2,0,2,1,7,2,0,2,5,2,0,2,7,1,2,0,2,0,1
1,5,1,1,0,0,0,1,7,0,1,0,7,1,0,0,0,1,1,5,1
1,0,1,0,6,1,2,0,0,2,0,2,0,0,2,1,6,0,1,0,1
1,2,1,2,1,5,0,0,1,0,2,0,1,0,0,5,1,2,1,2,1
1,0,0,0,0,2,1,2,0,2,0,2,0,2,1,2,0,0,0,0,1
1,0,4,0,0,1,5,2,0,1,4,1,0,2,5,1,0,0,4,0,1
1,0,0,0,0,2,0,1,7,0,2,0,7,1,0,2,0,0,0,0,1
1,1,1,1,1,1,1,1,1,1,1,1,1,1,1,1,1,1,1,1,1