WIDTH=15
HEIGHT=15
1,1,1,1,1,1,1,1,1,1,1,1,1,1,1
1,3,0,0,2,2,6,5,6,2,2,0,0,0,1
1,0,0,0,1,0,1,2,1,0,1,0,0,0,1
1,0,0,0,1,7,1,0,1,7,1,0,0,0,1
1,1,2,1,1,2,6,5,6,2,1,1,2,1,1
1,6,0,5,2,0,2,2,2,0,2,5,0,6,1
1,2,1,2,1,7,2,0,2,7,1,2,1,2,1
1,0,5,2,0,2,0,5,0,2,0,2,5,0,1
1,2,1,2,1,7,2,0,2,7,1,2,1,2,1
1,6,0,5,2,0,2,2,2,0,2,5,0,6,1
1,1,2,1,1,2,6,5,6,2,1,1,2,1,1
1,0,0,0,1,7,1,0,1,7,1,0,0,0,1
1,0,0,0,1,0,1,2,1,0,1,0,0,0,1
1,0,0,0,2,2,6,5,6,2,2,0,0,0,1
1,1,1,1,1,1,1,1,1,1,1,1,1,1,1